1 0 0 0 0 0 0 0 0 0 0 0 0 0 0 0 0 0 0 0 0 0 0 0 0 0 0 0 0 0 0 0 0 0 0 0 0 0 0 0 0 0 0 0 0 0 0 0 0 2
1 0 9 0 9 0 9 0 9 0 0 9 0 9 0 0 9 0 9 0 9 0 9 0 0 9 0 9 0 0 9 0 9 0 9 0 9 0 0 9 0 9 0 0 9 0 9 0 0 3
1 0 9 0 9 0 9 0 9 0 0 9 0 9 0 0 9 0 9 0 9 0 9 0 0 9 0 9 0 0 9 0 9 0 9 0 9 0 0 9 0 9 0 0 9 0 9 0 0 4
1 0 9 0 9 0 9 0 9 0 0 9 0 9 0 0 9 0 9 0 9 0 9 0 0 9 0 9 0 0 9 0 9 0 9 0 9 0 0 9 0 9 0 0 9 0 9 0 0 5
1 0 9 0 9 0 9 0 9 0 0 9 0 9 0 0 9 0 9 0 9 0 9 0 0 9 0 9 0 0 9 0 9 0 9 0 9 0 0 9 0 9 0 0 9 0 9 0 0 5
1 0 9 0 9 0 9 0 9 0 0 9 0 9 0 0 9 0 9 0 9 0 9 0 0 9 0 9 0 0 9 0 9 0 9 0 9 0 0 9 0 9 0 0 9 0 9 0 0 5
1 0 9 0 9 0 9 0 9 0 0 9 0 9 0 0 9 0 9 0 9 0 9 0 0 9 0 9 0 0 9 0 9 0 9 0 9 0 0 9 0 9 0 0 9 0 9 0 0 5
1 0 9 0 9 0 9 0 9 0 0 9 0 9 0 0 9 0 9 0 9 0 9 0 0 9 0 9 0 0 9 0 9 0 9 0 9 0 0 9 0 9 0 0 9 0 9 0 0 5
1 0 9 0 9 0 9 0 9 0 0 9 0 9 0 0 9 0 9 0 9 0 9 0 0 9 0 9 0 0 9 0 9 0 9 0 9 0 0 9 0 9 0 0 9 0 9 0 0 5
1 0 9 0 9 0 9 0 9 0 0 9 0 9 0 0 9 0 9 0 9 0 9 0 0 9 0 9 0 0 9 0 9 0 9 0 9 0 0 9 0 9 0 0 9 0 9 0 0 5
1 0 9 0 9 0 9 0 9 0 0 9 0 9 0 0 9 0 9 0 9 0 9 0 0 9 0 9 0 0 9 0 9 0 9 0 9 0 0 9 0 9 0 0 9 0 9 0 0 5
1 0 9 0 9 0 9 0 9 0 0 9 0 9 0 0 9 0 9 0 9 0 9 0 0 9 0 9 0 0 9 0 9 0 9 0 9 0 0 9 0 9 0 0 9 0 9 0 5 0
1 0 9 0 9 0 9 0 9 0 0 9 0 9 0 0 9 0 9 0 9 0 9 0 0 9 0 9 0 0 9 0 9 0 9 0 9 0 0 9 0 9 0 0 9 0 9 0 5 0
1 0 9 0 9 0 9 0 9 0 0 9 0 9 0 0 9 0 9 0 9 0 9 0 0 9 0 9 0 0 9 0 9 0 9 0 9 0 0 9 0 9 0 0 9 0 9 0 5 0
1 0 9 0 9 0 9 0 9 0 0 9 0 9 0 0 9 0 9 0 9 0 9 0 0 9 0 9 0 0 9 0 9 0 9 0 9 0 0 9 0 9 0 0 9 0 9 0 5 0
1 0 9 0 9 0 9 0 9 0 0 9 0 9 0 0 9 0 9 0 9 0 9 0 0 9 0 9 0 0 9 0 9 0 9 0 9 0 0 9 0 9 0 0 9 0 9 0 5 0
1 0 9 0 9 0 9 0 9 0 0 9 0 9 0 0 9 0 9 0 9 0 9 0 0 9 0 9 0 0 9 0 9 0 9 0 9 0 0 9 0 9 0 0 9 0 9 0 5 0
1 0 9 0 9 0 9 0 9 0 0 9 0 9 0 0 9 0 9 0 9 0 9 0 0 9 0 9 0 0 9 0 9 0 9 0 9 0 0 9 0 9 0 0 9 0 9 0 5 0
1 0 9 0 9 0 9 0 9 0 0 9 0 9 0 0 9 0 9 0 9 0 9 0 0 9 0 9 0 0 9 0 9 0 9 0 9 0 0 9 0 9 0 0 9 0 9 0 5 0
1 0 9 0 9 0 9 0 9 0 0 9 0 9 0 0 9 0 9 0 9 0 9 0 0 9 0 9 0 0 9 0 9 0 9 0 9 0 0 9 0 9 0 0 9 0 9 0 5 0
1 0 9 0 9 0 9 0 9 0 0 9 0 9 0 0 9 0 9 0 9 0 9 0 0 9 0 9 0 0 9 0 9 0 9 0 9 0 0 9 0 9 0 0 9 0 9 0 5 0
1 0 9 0 9 0 9 0 9 0 0 9 0 9 0 0 9 0 9 0 9 0 9 0 0 9 0 9 0 0 9 0 9 0 9 0 9 0 0 9 0 9 0 0 9 0 9 0 5 0
1 0 9 0 9 0 9 0 9 0 0 9 0 9 0 0 9 0 9 0 9 0 9 0 0 9 0 9 0 0 9 0 9 0 9 0 9 0 0 9 0 9 0 0 9 0 9 0 5 0
1 0 9 0 9 0 9 0 9 0 0 9 0 9 0 0 9 0 9 0 9 0 9 0 0 9 0 9 0 0 9 0 9 0 9 0 9 0 0 9 0 9 0 0 9 0 9 0 5 0
1 0 9 0 9 0 9 0 9 0 0 9 0 9 0 0 9 0 9 0 9 0 9 0 0 9 0 9 0 0 9 0 9 0 9 0 9 0 0 9 0 9 0 0 9 0 9 0 5 0
1 0 9 0 9 0 9 0 9 0 0 9 0 9 0 0 9 0 9 0 9 0 9 0 0 9 0 9 0 0 9 0 9 0 9 0 9 0 0 9 0 9 0 0 9 0 9 0 5 0
1 0 9 0 9 0 9 0 9 0 0 9 0 9 0 0 9 0 9 0 9 0 9 0 0 9 0 9 0 0 9 0 9 0 9 0 9 0 0 9 0 9 0 0 9 0 9 0 5 0
1 0 9 0 9 0 9 0 9 0 0 9 0 9 0 0 9 0 9 0 9 0 9 0 0 9 0 9 0 0 9 0 9 0 9 0 9 0 0 9 0 9 0 0 9 0 9 0 5 0
1 0 9 0 9 0 9 0 9 0 0 9 0 9 0 0 9 0 9 0 9 0 9 0 0 9 0 9 0 0 9 0 9 0 9 0 9 0 0 9 0 9 0 0 9 0 9 0 5 0
1 0 9 0 9 0 9 0 9 0 0 9 0 9 0 0 9 0 9 0 9 0 9 0 0 9 0 9 0 0 9 0 9 0 9 0 9 0 0 9 0 9 0 0 9 0 9 0 5 0
1 7 7 7 7 7 7 7 1 0 0 9 0 9 0 0 9 0 9 0 9 0 9 0 0 9 0 9 0 0 9 0 9 0 9 0 9 0 0 9 0 9 0 0 9 0 9 0 5 0
1 6 6 6 6 6 6 6 0 0 0 9 0 9 0 0 9 0 9 0 9 0 9 0 0 9 0 9 0 0 9 0 9 0 9 0 9 0 0 9 0 9 0 0 9 0 9 0 5 0
1 0 9 0 9 0 9 0 1 0 0 9 0 9 0 0 9 0 9 0 9 0 9 0 0 9 0 9 0 0 9 0 9 0 9 0 9 0 0 9 0 9 0 0 9 0 9 0 5 0
1 0 9 0 9 0 9 0 1 0 0 9 0 9 0 0 9 0 9 0 9 0 9 0 0 9 0 9 0 0 9 0 9 0 9 0 9 0 0 9 0 9 0 0 9 0 9 0 5 0
1 0 9 0 9 0 9 0 1 0 0 9 0 9 0 0 9 0 9 0 9 0 9 0 0 9 0 9 0 0 9 0 9 0 9 0 9 0 0 9 0 9 0 0 9 0 9 0 5 0
1 0 9 0 9 0 9 0 1 0 0 9 0 9 0 0 9 0 9 0 9 0 9 0 0 9 0 9 0 0 9 0 9 0 9 0 9 0 0 9 0 9 0 0 9 0 9 0 5 0
1 0 9 0 9 0 9 0 1 0 0 9 0 9 0 0 9 0 9 0 9 0 9 0 0 9 0 9 0 0 9 0 9 0 9 0 9 0 0 9 0 9 0 0 9 0 9 0 5 0
1 0 0 0 0 0 0 0 1 0 0 9 0 9 0 0 9 0 9 0 9 0 9 0 0 9 0 9 0 0 9 0 9 0 9 0 9 0 0 9 0 9 0 0 9 0 9 0 5 0
1 7 7 7 7 7 7 7 1 0 0 9 0 9 0 0 9 0 9 0 9 0 9 0 0 9 0 9 0 0 9 0 9 0 9 0 9 0 0 9 0 9 0 0 9 0 9 0 5 0
1 6 6 6 6 6 6 6 0 0 0 9 0 9 0 0 9 0 9 0 9 0 9 0 0 9 0 9 0 0 9 0 9 0 9 0 9 0 0 9 0 9 0 0 9 0 9 0 5 0
1 0 9 0 9 0 9 0 1 0 0 9 0 9 0 0 9 0 9 0 9 0 9 0 0 9 0 9 0 0 9 0 9 0 9 0 9 0 0 9 0 9 0 0 9 0 9 0 5 0
1 0 9 0 9 0 9 0 1 0 0 9 0 9 0 0 9 0 9 0 9 0 9 0 0 9 0 9 0 0 9 0 9 0 9 0 9 0 0 9 0 9 0 0 9 0 9 0 5 0
1 0 9 0 9 0 9 0 1 0 0 9 0 9 0 0 9 0 9 0 9 0 9 0 0 9 0 9 0 0 9 0 9 0 9 0 9 0 0 9 0 9 0 0 9 0 9 0 5 0
1 0 9 0 9 0 9 0 1 0 0 9 0 9 0 0 9 0 9 0 9 0 9 0 0 9 0 9 0 0 9 0 9 0 9 0 9 0 0 9 0 9 0 0 9 0 9 0 5 0
1 0 9 0 9 0 9 0 1 0 0 9 0 9 0 0 9 0 9 0 9 0 9 0 0 9 0 9 0 0 9 0 9 0 9 0 9 0 0 9 0 9 0 0 9 0 9 0 5 0
1 0 0 0 0 0 0 0 1 0 0 9 0 9 0 0 9 0 9 0 9 0 9 0 0 9 0 9 0 0 9 0 9 0 9 0 9 0 0 9 0 9 0 0 9 0 9 0 5 0
3 3 3 3 3 3 3 3 3 0 0 9 0 9 0 0 9 0 9 0 9 0 9 0 0 9 0 9 0 0 9 0 9 0 9 0 9 0 0 9 0 9 0 0 9 0 9 0 5 0
5 5 5 5 5 5 5 5 5 5 5 5 5 5 5 5 5 5 5 5 5 5 5 5 5 5 5 5 5 5 5 5 5 5 5 5 5 5 5 5 5 5 5 5 5 5 5 5 5 5
5 5 5 5 5 5 5 5 5 5 5 5 5 5 5 5 5 5 5 5 5 5 5 5 5 5 5 5 5 5 5 5 5 5 5 5 5 5 5 5 5 5 5 5 5 5 5 5 5 5
5 5 5 5 5 5 5 5 5 5 5 5 5 5 5 5 5 5 5 5 5 5 5 5 5 5 5 5 5 5 5 5 5 5 5 5 5 5 5 5 5 5 5 5 5 5 5 5 5 5