1 0 0 0 0 0 0 0 0 0 0 0 0 0 0 2
1 0 9 0 9 0 9 0 9 0 0 9 0 9 0 3
1 0 9 0 9 0 9 0 9 0 0 9 0 9 0 4
1 0 9 0 9 0 9 0 9 0 0 9 0 9 0 5
1 0 9 0 9 0 9 0 9 0 0 9 0 9 0 5
1 0 9 0 9 0 9 0 9 0 0 9 0 9 0 5
1 0 9 0 9 0 9 0 9 0 0 9 0 9 0 5
7 8 8 8 8 8 8 8 8 8 8 8 8 8 8 6
