1 0 0 0 0 0 0 0 0 0 0 0 0 0 0 0 0 0 0 0 0 0 0 0 0 0 0 0 0 0 0 0 0 0 0 0 0 0 0 0 0 0 0 0 0 0 0 0 0 2
1 0 9 0 9 0 9 0 9 0 0 9 0 9 0 0 9 0 9 0 9 0 9 0 0 9 0 9 0 0 9 0 9 0 9 0 9 0 0 9 0 9 0 0 9 0 9 0 0 3
1 0 9 0 9 0 9 0 9 0 0 9 0 9 0 0 9 0 9 0 9 0 9 0 0 9 0 9 0 0 9 0 9 0 9 0 9 0 0 9 0 9 0 0 9 0 9 0 0 4
1 0 9 0 9 0 9 0 9 0 0 9 0 9 0 0 9 0 9 0 9 0 9 0 0 9 0 9 0 0 9 0 9 0 9 0 9 0 0 9 0 9 0 0 9 0 9 0 0 5
1 0 9 0 9 0 9 0 9 0 0 9 0 9 0 0 9 0 9 0 9 0 9 0 0 9 0 9 0 0 9 0 9 0 9 0 9 0 0 9 0 9 0 0 9 0 9 0 0 5
1 0 9 0 9 0 9 0 9 0 0 9 0 9 0 0 9 0 9 0 9 0 9 0 0 9 0 9 0 0 9 0 9 0 9 0 9 0 0 9 0 9 0 0 9 0 9 0 0 5
1 0 9 0 9 0 9 0 9 0 0 9 0 9 0 0 9 0 9 0 9 0 9 0 0 9 0 9 0 0 9 0 9 0 9 0 9 0 0 9 0 9 0 0 9 0 9 0 0 5
1 0 9 0 9 0 9 0 9 0 0 9 0 9 0 0 9 0 9 0 9 0 9 0 0 9 0 9 0 0 9 0 9 0 9 0 9 0 0 9 0 9 0 0 9 0 9 0 0 5
1 0 9 0 9 0 9 0 9 0 0 9 0 9 0 0 9 0 9 0 9 0 9 0 0 9 0 9 0 0 9 0 9 0 9 0 9 0 0 9 0 9 0 0 9 0 9 0 0 5
1 0 9 0 9 0 9 0 9 0 0 9 0 9 0 0 9 0 9 0 9 0 9 0 0 9 0 9 0 0 9 0 9 0 9 0 9 0 0 9 0 9 0 0 9 0 9 0 0 5
1 0 9 0 9 0 9 0 9 0 0 9 0 9 0 0 9 0 9 0 9 0 9 0 0 9 0 9 0 0 9 0 9 0 9 0 9 0 0 9 0 9 0 0 9 0 9 0 0 5
1 0 9 0 9 0 9 0 9 0 0 9 0 9 0 0 9 0 9 0 9 0 9 0 0 9 0 9 0 0 9 0 9 0 9 0 9 0 0 9 0 9 0 0 9 0 9 0 5 0
1 0 9 0 9 0 9 0 9 0 0 9 0 9 0 0 9 0 9 0 9 0 9 0 0 9 0 9 0 0 9 0 9 0 9 0 9 0 0 9 0 9 0 0 9 0 9 0 5 0
1 0 9 0 9 0 9 0 9 0 0 9 0 9 0 0 9 0 9 0 9 0 9 0 0 9 0 9 0 0 9 0 9 0 9 0 9 0 0 9 0 9 0 0 9 0 9 0 5 0
1 0 9 0 9 0 9 0 9 0 0 9 0 9 0 0 9 0 9 0 9 0 9 0 0 9 0 9 0 0 9 0 9 0 9 0 9 0 0 9 0 9 0 0 9 0 9 0 5 0
1 0 9 0 9 0 9 0 9 0 0 9 0 9 0 0 9 0 9 0 9 0 9 0 0 9 0 9 0 0 9 0 9 0 9 0 9 0 0 9 0 9 0 0 9 0 9 0 5 0
1 0 9 0 9 0 9 0 9 0 0 9 0 9 0 0 9 0 9 0 9 0 9 0 0 9 0 9 0 0 9 0 9 0 9 0 9 0 0 9 0 9 0 0 9 0 9 0 5 0
1 0 9 0 9 0 9 0 9 0 0 9 0 9 0 0 9 0 9 0 9 0 9 0 0 9 0 9 0 0 9 0 9 0 9 0 9 0 0 9 0 9 0 0 9 0 9 0 5 0
1 0 9 0 9 0 9 0 9 0 0 9 0 9 0 0 9 0 9 0 9 0 9 0 0 9 0 9 0 0 9 0 9 0 9 0 9 0 0 9 0 9 0 0 9 0 9 0 5 0
1 0 9 0 9 0 9 0 9 0 0 9 0 9 0 0 9 0 9 0 9 0 9 0 0 9 0 9 0 0 9 0 9 0 9 0 9 0 0 9 0 9 0 0 9 0 9 0 5 0
1 0 9 0 9 0 9 0 9 0 0 9 0 9 0 0 9 0 9 0 9 0 9 0 0 9 0 9 0 0 9 0 9 0 9 0 9 0 0 9 0 9 0 0 9 0 9 0 5 0
1 0 9 0 9 0 9 0 9 0 0 9 0 9 0 0 9 0 9 0 9 0 9 0 0 9 0 9 0 0 9 0 9 0 9 0 9 0 0 9 0 9 0 0 9 0 9 0 5 0
1 0 9 0 9 0 9 0 9 0 0 9 0 9 0 0 9 0 9 0 9 0 9 0 0 9 0 9 0 0 9 0 9 0 9 0 9 0 0 9 0 9 0 0 9 0 9 0 5 0
1 0 9 0 9 0 9 0 9 0 0 9 0 9 0 0 9 0 9 0 9 0 9 0 0 9 0 9 0 0 9 0 9 0 9 0 9 0 0 9 0 9 0 0 9 0 9 0 5 0
1 0 9 0 9 0 9 0 9 0 0 9 0 9 0 0 9 0 9 0 9 0 9 0 0 9 0 9 0 0 9 0 9 0 9 0 9 0 0 9 0 9 0 0 9 0 9 0 5 0
1 0 9 0 9 0 9 0 9 0 0 9 0 9 0 0 9 0 9 0 9 0 9 0 0 9 0 9 0 0 9 0 9 0 9 0 9 0 0 9 0 9 0 0 9 0 9 0 5 0
1 0 9 0 9 0 9 0 9 0 0 9 0 9 0 0 9 0 9 0 9 0 9 0 0 9 0 9 0 0 9 0 9 0 9 0 9 0 0 9 0 9 0 0 9 0 9 0 5 0
1 0 9 0 9 0 9 0 9 0 0 9 0 9 0 0 9 0 9 0 9 0 9 0 0 9 0 9 0 0 9 0 9 0 9 0 9 0 0 9 0 9 0 0 9 0 9 0 5 0
1 0 9 0 9 0 9 0 9 0 0 9 0 9 0 0 9 0 9 0 9 0 9 0 0 9 0 9 0 0 9 0 9 0 9 0 9 0 0 9 0 9 0 0 9 0 9 0 5 0
1 0 9 0 9 0 9 0 9 0 0 9 0 9 0 0 9 0 9 0 9 0 9 0 0 9 0 9 0 0 9 0 9 0 9 0 9 0 0 9 0 9 0 0 9 0 9 0 5 0
1 0 9 0 9 0 9 0 9 0 0 9 0 9 0 0 9 0 9 0 9 0 9 0 0 9 0 9 0 0 9 0 9 0 9 0 9 0 0 9 0 9 0 0 9 0 9 0 5 0
1 0 9 0 9 0 9 0 9 0 0 9 0 9 0 0 9 0 9 0 9 0 9 0 0 9 0 9 0 0 9 0 9 0 9 0 9 0 0 9 0 9 0 0 9 0 9 0 5 0
1 0 9 0 9 0 9 0 9 0 0 9 0 9 0 0 9 0 9 0 9 0 9 0 0 9 0 9 0 0 9 0 9 0 9 0 9 0 0 9 0 9 0 0 9 0 9 0 5 0
1 0 9 0 9 0 9 0 9 0 0 9 0 9 0 0 9 0 9 0 9 0 9 0 0 9 0 9 0 0 9 0 9 0 9 0 9 0 0 9 0 9 0 0 9 0 9 0 5 0
1 0 9 0 9 0 9 0 9 0 0 9 0 9 0 0 9 0 9 0 9 0 9 0 0 9 0 9 0 0 9 0 9 0 9 0 9 0 0 9 0 9 0 0 9 0 9 0 5 0
1 0 9 0 9 0 9 0 9 0 0 9 0 9 0 0 9 0 9 0 9 0 9 0 0 9 0 9 0 0 9 0 9 0 9 0 9 0 0 9 0 9 0 0 9 0 9 0 5 0
1 0 9 0 9 0 9 0 9 0 0 9 0 9 0 0 9 0 9 0 9 0 9 0 0 9 0 9 0 0 9 0 9 0 9 0 9 0 0 9 0 9 0 0 9 0 9 0 5 0
1 0 9 0 9 0 9 0 9 0 0 9 0 9 0 0 9 0 9 0 9 0 9 0 0 9 0 9 0 0 9 0 9 0 9 0 9 0 0 9 0 9 0 0 9 0 9 0 5 0
1 0 9 0 9 0 9 0 9 0 0 9 0 9 0 0 9 0 9 0 9 0 9 0 0 9 0 9 0 0 9 0 9 0 9 0 9 0 0 9 0 9 0 0 9 0 9 0 5 0
1 0 9 0 9 0 9 0 9 0 0 9 0 9 0 0 9 0 9 0 9 0 9 0 0 9 0 9 0 0 9 0 9 0 9 0 9 0 0 9 0 9 0 0 9 0 9 0 5 0
1 0 9 0 9 0 9 0 9 0 0 9 0 9 0 0 9 0 9 0 9 0 9 0 0 9 0 9 0 0 9 0 9 0 9 0 9 0 0 9 0 9 0 0 9 0 9 0 5 0
1 0 9 0 9 0 9 0 9 0 0 9 0 9 0 0 9 0 9 0 9 0 9 0 0 9 0 9 0 0 9 0 9 0 9 0 9 0 0 9 0 9 0 0 9 0 9 0 5 0
1 0 9 0 9 0 9 0 9 0 0 9 0 9 0 0 9 0 9 0 9 0 9 0 0 9 0 9 0 0 9 0 9 0 9 0 9 0 0 9 0 9 0 0 9 0 9 0 5 0
1 0 9 0 9 0 9 0 9 0 0 9 0 9 0 0 9 0 9 0 9 0 9 0 0 9 0 9 0 0 9 0 9 0 9 0 9 0 0 9 0 9 0 0 9 0 9 0 5 0
1 0 9 0 9 0 9 0 9 0 0 9 0 9 0 0 9 0 9 0 9 0 9 0 0 9 0 9 0 0 9 0 9 0 9 0 9 0 0 9 0 9 0 0 9 0 9 0 5 0
1 0 9 0 9 0 9 0 9 0 0 9 0 9 0 0 9 0 9 0 9 0 9 0 0 9 0 9 0 0 9 0 9 0 9 0 9 0 0 9 0 9 0 0 9 0 9 0 5 0
1 0 9 0 9 0 9 0 9 0 0 9 0 9 0 0 9 0 9 0 9 0 9 0 0 9 0 9 0 0 9 0 9 0 9 0 9 0 0 9 0 9 0 0 9 0 9 0 5 0
1 0 9 0 9 0 9 0 9 0 0 9 0 9 0 0 9 0 9 0 9 0 9 0 0 9 0 9 0 0 9 0 9 0 9 0 9 0 0 9 0 9 0 0 9 0 9 0 5 0
1 0 9 0 9 0 9 0 9 0 0 9 0 9 0 0 9 0 9 0 9 0 9 0 0 9 0 9 0 0 9 0 9 0 9 0 9 0 0 9 0 9 0 0 9 0 9 0 5 0
7 8 8 8 8 8 8 8 8 8 8 8 8 8 8 8 8 8 8 8 8 8 8 8 8 8 8 8 8 8 8 8 8 8 8 8 8 8 8 8 8 8 8 8 8 8 8 8 6 0
